{
  "ಕ": 0,
  "ಖ": 1,
  "ಗ": 2,
  "ಘ": 3,
  "ಙ": 4,
  "ಚ": 5,
  "ಛ": 6,
  "ಜ": 7,
  "ಝ": 8,
  "ಞ": 9,
  "ಟ": 10,
  "ಠ": 11,
  "ಡ": 12,
  "ಢ": 13,
  "ಣ": 14,
  "ತ": 15,
  "ಥ": 16,
  "ದ": 17,
  "ಧ": 18,
  "ನ": 19,
  "ಪ": 20,
  "ಫ": 21,
  "ಬ": 22,
  "ಭ": 23,
  "ಮ": 24,
  "ಯ": 25,
  "ರ": 26,
  "ಲ": 27,
  "ಳ": 28,
  "ವ": 29,
  "ಶ": 30,
  "ಷ": 31,
  "ಸ": 32,
  "ಹ": 33
}